11111111111111111111
100000P0000000010001
10011111100000010001
10000100000000000001
1C001100011100000C01
10001110000100000001
10001000000111110001
10E010000C0000000001
10001000000000010001
11111111111111111111
