111111111111111111111111111111
1000000000000000000000000000E1
100000000000000000000000000001
1000C0000000000000000000000001
100000000000000000000000000001
100000000C00000000000000000001
100000000000000000000000000001
10000000000000C000000000000001
100000000000000000000000000001
1000000111110000000C0000000001
100000000000000000000000000001
100000000000000000000000C00001
100000000000000000000000000001
1000000C000000000P000000000001
100000000000000000000000000001
10000000000C000000011110000001
100000000000000000000100000001
100000000000000C00000100000001
100000000000000000000100000001
10000000000011100000C100000001
100000000001100000000000000001
10000000000010000000000C000001
100000000000100000000000000001
10000C000000100000000000000001
100000000000000000000000000001
1000000000000C0000000000000001
100000000000000000000000000001
100000000000000000000000000001
100000000000000000000000000001
111111111111111111111111111111
